R 9080 1080
NO textures/ocean.xpm
SO ./textures/sea4.xpm
WE textures/mount.xpm
EA textures/sea4.xpm
S ./textures/palma.xpm
F 195, 174, 192
C 85, 142, 191

        1111111111111111111111111
        1000000000110002000002001
        1011000001110200002020001
        1001000000000200000200201
111111111011000001110000000000001
100000000011000001110111110111111
11110111111111011100000012021
11110111111111011101010012021
11000000110101011100000012021
10002000000000001100000012021
10000000000000001101010012021
11000001110101011111011110N0111
11110111 1110101 101111010001
11111111 1111111 111111111111
